TILEMAP
30 17 							-- Size of tile map in tiles
32 32						-- Tile size & block size
images/blocks.png 	-- Tilesheet
10 7								-- Number of tiles in tilesheet
2,2,2,2,2,2,2,2,2,2,2,2,2,2,2,2,2,2,2,2,2,2,2,2,2,2,2,2,2,2
2, , , , , , , , , , , , , , , , , , , , , , , , , , , , ,2
2, , , , , , , , , , , , , , , , , , , , , , , , , , , , ,2
2, , , , , , , , , , , , , , , , , , , , , , , , , , , , ,2
2, , , , , , , , , , , , , , , , , , , , , , , , , , , , ,2
2, , , , , , , , ,44, , , , , , , , , , , , , , , , , , , ,2
2, , , , , , ,8, ,50, , , , , , , , , , , , , , , , , , , ,2
2, , ,3,4,5, , , ,62, , , , , , , , , , , , , , ,3,4,5, , ,2
2, , ,8,8,8,8,8,8,8,8,8,8,8,8,8,8,8,8,8,8,8,8,8,8,8,8, , ,2
2, , ,4, , , , , ,8, ,8, , , , , , , , , , , , , , ,4, , ,2
2, , , , , , , ,8, , , , , , , , , , , , , , , , , , , , ,2
2, , , , , , , , , , , , , , , , , , , , , , , , , , , , ,2
2, , , , , , , , , , , , , , , , , , , , , , , , , , , , ,2
2, , , , , , , , , , , , , , , , , , , , , , , , , , , , ,2
2, , , , , , , , , , , , , , , , , , , , , , , , , , , , ,2
2, , , , , , , , , , , , , , , , , , , , , , , , , , , , ,2
2,2,2,2,2,2,2,2,2,2,2,2,2,2,2,2,2,2,2,2,2,2,2,2,2,2,2,2,2,2