TILEMAP
30 17 							-- Size of tile map in tiles
32 32						-- Tile size & block size
images/tilerow.png 	-- Tilesheet
9 1								-- Number of tiles in tilesheet
111111111111111111111111111111
1                            1
1                            1
1                            1
1                            1
1                            1
1                            1
1  345                  345  1
1  888888888888888888888888  1
1  100000000000000000000001  1
1                            1
1                            1
1                            1
1                            1
1                            1
1                            1
111111111111111111111111111111
